1111111111111111
1P0000CC000Y00E1
1111111111111111