1111111111111111
1PY000CC000Y00E1
1111111111111111