1111111111111111
1P0000CC000000E1
1111111111111111