1111111
1C010C1
1001001
1011011
1PC00E1
1111111