1111111111111
10CE0000000C1
10P1CC1111001
1000011000011
1111111111111