1111111
10C0C01
1111101
1000001
1010111
1C00011
1111001
10CCCC1
10111C1
1P0E1C1
1111111