1111111
10C0C01
1111101
100Y001
1010111
100Y011
1111001
10CCCC1
10111C1
1P0E1C1
1111111