1111111111111
10010000000C1
10P0CC1111001
10E0111000001
1111111111111