1111111111111
10C10000000C1
10P1CC1111001
10E0011000011
1111111111111